C      225,30,0
NO         ./path_to_the_north_texture
EA         ./path_to_the_east_texture
WE         ./path_to_the_west_texture
SO         ./path_to_the_south_texture
F      255,55,55

11111111111111111
10000000000000001
10000000000000001
10000000000000001
10000000000000001
10000000000000001
10000000000000001
10000000000000001
10000000100000001
10000000000000001
1000S000000000001
10000000000000001
10000000000000001
10010100001000001
10010100000000001
11111111111111111