NO                       ./path_to_the_north_texture
EA         ./path_to_the_east_texture
C      100,2,100



WE         ./path_to_the_west_texture
SO         ./path_to_the_south_texture
F      0,0,255

11111111111111111111111111111111
        11111111111111111
     1111111111111111111
11111111111111111111111111111111
  11111111111111111111111111
11000000000000000000000000001111
11000000000000000000000000001111
11000000000000000000000000001111
11000000011111110000000000001111
1110000001   110000000000001111
110000000111111100000000000001111
11000000000000000W00000000001111
11000000000000000000000000001111
11000000000000000000000000001111
11111111111111111111111111111111
11111111111111111111111111111111
111111111111111
