C      0,255,0
NO         ./path_to_the_north_texture
EA         ./path_to_the_east_texture
WE         ./path_to_the_west_texture
SO         ./path_to_the_south_texture
F      0,0,255

11111111111111111111111111111111
11111111111111111111111111111111
11111111111111111111111111111111
11111111111111111111111111111111
11111111111111111111111111111111
11000000000000000000000000001111
11000000000000000000000000001111
11000000000000000000000000001111
11000000000000000000000000001111
1110000000000W000000000000001111
11000000000000000000000000001111
11000000000000000000000000001111
11000000000000000000000000001111
11000000000000000000000000001111
11111111111111111111111111111111
11111111111111111111111111111111
11111111111111111111111111111111
11111111111111111111111111111111
11111111111111111111111111111111
