C      225,30,0
NO         ./path_to_the_north_texture
EA         ./path_to_the_east_texture
WE         ./path_to_the_west_texture
SO         ./path_to_the_south_texture
F      255,55,55

1111111111111111111111111
1000000000000000000000001
1000000000000000000000001
1000S0000000000000000000111111111
100000000000000000000000000001
1000000000000000000000011111111
111101111111111111111111111111
111101111111     101010010001
11000000110111111100000010001
10000000000000001100000010001
1000000000000001101010010001
110000011101010111110111100111
11110111 1110101 101111010001
1111111 111111111 11111111111111111
