C      225,30,0
NO         ./path_to_the_north_texture
EA         ./path_to_the_east_texture
WE         ./path_to_the_west_texture
SO         ./path_to_the_south_texture
F      255,55,55

         111111111111111111111111
        1000000000110000000000001
        1011000001110000000000001
        1001000000000000000000001
111111111011000001110000000000001
100000000011000001110111111111111
11110111111111111100000010001
111101111111     101010010001
11000000110111111100000010001
10000000000000001100000010001
1000000000000001101010010001
11000001110101011111011110S0111
11110111 1110101 101111010001
1111111 1111111 11111111111111111